8 12
111000001111
000011101111
022044101111
012241100000
015010101110
011411111410
011000000020
000011111000
