11 11
11100011111
11001010000
10011000110
00141111110
01115410110
00014000110
11011022110
10010020100
10111111001
10111110011
10000000111