101 101
#####################################################################################################
    #                     # # # # # # #     #   #       #       #   #         # # # # # #   # # # # #
# ### # # ### ### ##### ### # # # # # ##### # ### ### ##### ### # ### ### ##### # # # # ### # # # # #
#   # # # # # # # # # #                 # #       # #     # # #         #   #       #               #
# ##### ### # # ### # ##### # ##### # ### # ### ### ### ##### # ##### ### ##### ### ### # # # ### ###
#   # # #       # #   # # # #     # # # #     #       #     # # # # # #       # #       # # # # # # #
# ### ######### # # ### # ### ##### ### # ##### # # ##### ### # # # ### # ######### # # ####### # # #
#       # # # #     #       #   #     # # # # # # #   # #         #   # # # # # #   # # #   #       #
# # # ### # # ### ####### ######### ### # # # ##### ### ### ### ### ### ### # # ### # ### ######### #
# # #           # # # # # # # # #     #         #   #     #   #       # #       # # #         # # # #
##### ### # # ### # # # # # # # ### ### # ### ##### ### ### ##### ######### ### # ### # ####### # # #
#       # # #   #             #   #   # # #   # # # #   # #     # # # # #   #         #   # # #     #
# # # ####### ##### # ##### ### ### ######### # # ##### # ######### # # ### ### # # # # ### # # ### #
# # # #         # # # # # #       #   # # # #     # #     # # # #           #   # # # # #         # #
######### ### ### ##### # # ####### ### # # ### ### ##### # # # ### # # # # # # ############# ##### #
# # #     #         # #     # # #             # #               #   # # # # # # # # # #   # #   #   #
# # ### # ### ### ### # ##### # ### # ### ##### ### # # # ### ##### ############# # # # ### # ### ###
#       # #     # #     # #       # #   #   #   #   # # # # # #                         # #     # # #
# # # # ##### ##### ### # # ### ##### ### ### ##### ####### # ### # ############# ####### # ####### #
# # # # # # # #     #       # #   #     # # # # #       #         # # # # # # # # # # # # # # # # # #
# ####### # ########### ### # ##### # ##### # # ### ####### # # # ### # # # # # ### # # # # # # # # #
#   #           # # # # #       # # #   #             # # # # # # #               #       #         #
# ######### ### # # # ####### ### ### ####### # # # ### # ### ######### ##### # ### ### ### ##### # #
#     # # # # #         # # # # # # #     # # # # #   #     # # # # #   # # # #       #   # # # # # #
# # ### # ### # ### # ### # # # # # ### ### ##### ##### ####### # # ### # # ### ### ### ### # # ### #
# #         #     # # #             # #       #       # # # # #     #         #   # #             # #
### # ### ### ##### ####### ### ##### ### # ### # # ### # # # # ########### ##### ##### # ##### ### #
# # #   #       #       #   #   # # # # # #   # # #   # #       # # # # #   # # #     # #     #   # #
# ### ### # # ##### # ######### # # # # ### ####### ### # ####### # # # ### # # ### #################
#       # # # # # # #   # # # #           #   #       #     # # #         #       # # # # # # # # # #
### # ######### # ### ### # # # ### ### ### ##### # ### ##### # # ### # ####### ##### # # # # # # # #
# # #     #             #         #   #   #     # #       # #       # #     # # # #                 #
# ### # ##### # ### # ### ### ##### ### ### # ##### ####### # ### ##### # ### # # ### ### # # # ### #
# #   #     # # #   #       #   # # # # # # #   # #     #   # # #   # # #   # #   #   #   # # # # # #
# ##### # ### ##### # # # ### ### ### ### ### ### ##### ### # # ##### ### ### # ##### ### ####### # #
#       #   # # # # # # # #     # #             #   # # #     #   #         #   #       #   # #   # #
# # # ### ##### # ### ####### ### ### # # # # ### ### ####### # ##### # # ##### ### # # ##### ### # #
# # # #     #       # #   # # #   # # # # # #           # # # #     # # #     #   # # #     # #     #
# ####### ### ### ##### ### ### ### ######### ##### # ### # # # ##### # # # ##### ##### # ### ##### #
#     #     # # #     # #   #   # # # #   #       # #   #         # # # # #     #   # # #   # #     #
# # ##### ### # ### ### # ##### # # # # ##### # ##### ### # ### ### ### ### # ##### # ### ### ##### #
# # #   # # # #   #   # # # #             # # #   #     # # #   # #   # # # #     #           # # # #
# ##### ### # # ### ### # # ### ### ### ### ### ### # ### ##### # # ##### ### ##### # # ####### # # #
#     #         # #           # # #   #   #   # #   # #     # #       #         #   # # # # #       #
# # ### # # ### # ### # ### ### # ##### ### ##### # ### # ### # ### ### # # # ####### ### # ### #####
# # #   # # #     # # #   #         #       #     #   # # #       #   # # # # # # # # #   # # #     #
####### ### ##### # ### ####################### # # ### ##### ##### ##### ##### # # ##### # # # ### #
# #       # # #       # # # # # # # # # # # #   # # #     # #   # # #       # #       #           # #
# ### # ##### ##### ##### # # # # # # # # # ### ##### ##### # ### ### # # ### # ### ##### ### #######
#     # #     # #   # #                           #   # # # #   #   # # #         #     # # # # # # #
# # # ### ### # ### # ### # # # # # # # # # # # ### ### # # # ##### ### # # # # ### # ##### # # # # #
# # # #   #     #         # # # # # # # # # # # # # # # #     # # #   # # # # # # # #     #   # #   #
# ####### ##### ### # # # ####################### ### # # ##### # ### ########### ### # ##### # # ###
#     #   # # # # # # # # #     #                   #     # #       #     # # # #     # # # #       #
# # ####### # # # ######### ####### ### # # ##### ####### # ##### ####### # # # ### # ### # # ### ###
# #   # #               # # # # # # #   # # # # #     #           # # # #   #   # # #           #   #
### ### ### # # ### ##### # # # # ### ### ### # # ####### # # ### # # # ### ### # ### ##### ##### # #
#     # # # # # #   # #               # # # #       #     # # #           # #             #   # # # #
### ### # ######### # ### # # ### # ### ### # ######### # # ##### # ### ### ### # # # ##### ### ### #
#     #               #   # # #   # #     #   # # # # # # #   # # # # #   #     # # # # # #       # #
# # ##### # ######### ### ### ### ##### ### ### # # # ##### ### ##### # ######### ##### # ### ##### #
# #   #   # # # # #         #   #   #     # #                 #       # # # # # #           #   # # #
### ##### ### # # ### ### ##### ####### ### ### # # # ### ##### # ### # # # # # ############# ### ###
#     # # # #       # # #     # # # # #       # # # # #   # #   # # #           # # # # # # # # #   #
# # ### ### # ### ##### ### ##### # # # ######### ######### ### ### ### # # ### # # # # # # ### # ###
# # #     #     #   # # # #   #   #       # #         # # # # # #       # # #               # #     #
# ### ##### ##### ### # # ####### # ####### ### # ##### # # # ##### # # ####### # # ### ### # # #####
#       #     #             # # #   # #     #   # # #           # # # # # # # # # # #   #           #
# ### ##### ### # ##### # ### # ### # # ####### ### ##### ### ### ### ### # # ######### ### ### #####
#   #     #   # #     # #         #   # # #       #   # #   #   # #                   # #   #   # # #
# ##### ### ##### ####### ### ####### # # ### # ### ### # ### ### ### # ##### ##### ####### ### # # #
#     #   #   #     #       #   # # # # # #   # # # #       #   #   # #   # #     #   #     # #     #
# # ### ### ##### ####### ### ### # # # # ### ### # ##### ### ##### ### ### ### ### ##### ### ##### #
# # #         #       # # #     # # #                 # #   #     #           #   # #   # #     # # #
####### ### ##### # ### ### # ### # ### ### # ##### ### # ### # ### # # # ##### # ##### ####### # # #
# #       # #   # # #       # #         # # #     # #       # #   # # # #   #   #   # # #   # #     #
# ### # ##### ####### # # # ### # # # ### ### ##### ##### ### # ######### ### ### ### # # ### # #####
#   # # # #   # #     # # # #   # # # #           #   # #   # #   # # # # #   #           # # #   # #
# ####### ### # ### # ### ### # # ####### # # # ####### # ### # ### # # ##### ####### ##### # # ### #
# #   # #           # #     # # #   # #   # # # # # # #     # #           #     # # #   # #     #   #
# ### # ### # # # # ##### ####### ### ### # ##### # # # ####### ### # # ##### ### # ##### # ####### #
#   #   #   # # # # # # # # #           # #   #           # #     # # #     # # # # # # # # # #     #
# ### ##### # ####### # ### ### # # ### ### ######### ##### ### ####### # ##### # # # # # # # ##### #
# # # # # # #   #               # #   #   #     # # #   #   #     #   # #     #                     #
# # # # # ### ##### # # # # # # ### ### ######### # # ##### ### ##### ### ##### # ##### ### # # ### #
#               # # # # # # # # #     #     # # #       # #   # # # # #     # # # # #   # # # # #   #
### # # # # # ### ##### ### ##### # ### ##### # # ### ### ### ### # # ### ### ##### ##### ######### #
#   # # # # #   #         # #     #   # # # #       #   #   #   #           # # #     # # # # # #   #
# # ######### ### # # # # ### # # # ##### # # ### ### ### ### ##### # # # ### # ### ### # # # # ### #
# # # #   # # #   # # # # #   # # #   # # # #   # # # # # # # #     # # #   # # # #               # #
# ### ### # ######### ####### ##### ### # # # ##### ### # # # ### # ##### ### # # # ### ##### # ### #
#     # #   # # # # #       # #     # #         #                 # # # # #       # # #     # #     #
# # ### ### # # # # ##### ### # # ### ####### ### # # # # # # # # ### # ##### ### # # ######### ### #
# #   #   #           # # # # # # # # # # # # # # # # # # # # # # # #   #     #     #   # #       # #
### ### ### ### ### ### ### ####### # # # # # # ### # # ########### ### ##### ##### # ### ### # ### #
#         #   #   #       #   # # # # #           # # #   #           # # # # # # #         # # # # #
# # # # ### ### ### ### ### ### # # # # ### ### ### ### ####### ####### # # ### # ### ####### ### ###
# # # #       # #     #                   #   # #     #   # # # # # # #       # #   # # # #         #
####### ########### ##### ### ### # ### ### ####### ### ### # # # # # # ### ### # ### # # ### ### ###
#           #           #   #   # #   #   #   #       #                   #                 #   #    
#####################################################################################################
