6 9
110000111
000110000
011111410
010110410
012120510
000000000