8 12
000000000000
011111111110
011111444110
001014514110
022200444000
021211111110
022211111110
000000000000