7 10
0000000000
0111111110
0114141410
0050000010
0111212120
0111111110
0000000000